


first level
#######
#a###b#
#.###.#
#.....#
#######
-
a blob red 1
b end  red 1
-

test level
#######
#..#.a#
#.....#
#..b..#
#.....#
#...###
#.#####
#######
-
a blob red 1
b end  red 1



